DOC子目录下的文件内容

下面文件中以"DOC"结尾的文件要用WORD 97打开阅读. 

COVERU.DOC	软件用户手册封面
CONTU.DOC	软件用户手册目录
GCS??.DOC	软件用户手册章节, ??处为章节序号, 每章一个文件
COVERR.DOC	软件参考手册封面
CONTR.DOC	软件参考手册目录
C??.DOC		软件参考手册章节, ??处为章节序号, 每章一个文件
BARCHART.DOC	流通系统条码操作卡. 安装DT-1000后, WINDOWS\SYSTEM子目录下
		有一个条码字库文件C39HrP24DhTt,可在控制面板中将这个字库添加到系统中后,
		就能打印出条码字符.
SNAPSHOT.DOC	系统快捷键一览表
WEB.DOC		加装第三方WEB服务器的说明
START.DOC	软件操作入门指南
WORKSHT.DOC	机读格式工作单
RELEAS??.TXT	软件更新说明
GUIDE.DOC	系统选购指南
PLANING.DOC	系统预算方案
NEWS??.DOC	丹诚快讯
README.TXT 	本文件